0, 2,2,2, 2,2,0,  0
0, 2,0,11,13,2,2,  2
10,12,0,0, 0,2,0,102
0, 2,2,2, 0,2,2,  2
0, 0,0,2, 2,2,0,  0
0, 2,2,2, 0,2,2,  2
0, 2,0,2, 0,0,0,  2
0, 2,0,2, 2,2,2,  2